BABECAGEyyHzKDh8FnJs3oJgUYmq1GA9Uv1CLIlO1DF8Ny7YM30=
0	0	0	0	0	0	0	0	0	0
0	0	0	0	0	0	0	0	0	0
1	2	2	2	2	2	0	0	0	0
1	1	1	2	4	2	2	2	0	0
0	0	1	1	1	2	4	2	2	2
0	0	0	0	1	1	1	2	4	2
1	2	0	0	0	0	1	1	1	2
1	2	2	2	0	0	0	0	1	1
1	2	4	2	2	2	0	0	0	0
1	1	2	2	4	2	2	2	0	0
1	1	1	1	2	2	2	2	2	2
1	1	1	1	1	1	1	1	1	1
0	0	1	1	1	1	1	1	1	1
0	0	0	0	1	1	1	1	1	1
0	0	0	0	0	0	1	1	1	1
0	0	0	0	0	0	0	0	1	1