BABECAGE/UnL+KzaeC/kNCxpF0rKCty6G9r4T/1rcb4QN266nDI=
0	0	0	0	0	0	0	0	0	0
0	0	0	0	0	0	0	0	0	0
1	2	0	1	2	2	0	0	0	0
1	2	0	1	2	2	2	0	0	0
1	2	0	1	2	4	2	0	1	2
1	2	0	1	2	2	2	0	1	2
1	2	0	1	2	2	2	0	1	2
1	2	0	1	2	2	2	0	1	2
1	2	0	1	2	2	2	0	1	2
1	1	0	1	2	4	2	0	1	2
1	1	0	1	2	2	2	0	1	2
1	1	0	1	1	1	2	0	1	2
0	0	0	1	1	1	1	0	1	2
0	0	0	0	1	1	1	0	1	1
0	0	0	0	0	0	1	0	1	1
0	0	0	0	0	0	0	0	1	1